################################
###   #######     ###### $$ ####
#      ##         ####         #
# #    ##      % ####         ##
# #          M   ###         X+#
# #    #         ###    %    ###
#      ###      #####        ###
#  ##    ##-#   #####   ##   ### D:12
#   # ## ##  #  ############-### D:6
##   ##  # >##  ###########  ###
##  $## #### ##-# ########   ### D:11
## # #  ## ~~ #    #######   ### K:7,9
#~ #    #  ~~####   ####      ## K:4,10,8
#  ##M  ###  || #   ##   ###  ## D:10,9
##  #  # ## ###-###     ####  ## D:8
###   #   ### #-####    ####  ## D:7
###% ##   ##  #         #####  #
####          #  #   M  ## ~#  # K:5
####  ###    #  ###    ## % # ~# K:1
#######      # #### #  ##   #  #
####     #  #  ##########  ##  #
##       #  # ##########   ##  #
########  # # ####  ####   #)  #
########  ##              ##   #
#     ~##  #    ###   M  ###   # K:12
#      ## #     ####    ## #   #
#      ## #    #####   ##  #   #
# #$#  ###      #####  #   #   #
#  #   ###   M   #####-## #    # D:5
# #$#  ##        ####     #    #
#      ##~       ####   ##   M # K:11
#      ###      ####   ###     #
#      ###    #####    ###     #
# # #  ## #-####   $ M ##     $# D:4
# $#$  ## $ ###        ##      #
# # #  ##$  ###        ##  ~   # K:6
#      ## ]###      % ###      #
#      #######    ######       #
#      ######### ####### # # # #
# #$#  #################       #
#  #   ##################-#-#-## D:3,2,1
# #$#                    ^#^#!##
#                       ###~#~## K:3,2
#        # #      #$#   ########
#        $#$   M   #           #
#        # #      #$#          #
#                              #
################################
