################################
#    ^       ^     ^      = ^^ #
#    ^ M     ^  M  ^    ###### #
#  ######################    # #
#    ^       ^     ^    # 12 # #
#    ^ M     ^  M  ^    # 34 #^#
##################### X #     ^# B
# ^     ########################
#X^     ######################## A
######^^#      #################
#   ^   #      #################
#   ^   #      #################
#M ######      #################
#   ^   ^      #################
#   ^          #################
################################
