################################
#    ^       ^     ^      s ^^ #
#    ^ M     ^  M  ^    ###### #
#  ######################    # #
#    ^       ^     ^    # 12 # #
#    ^ M     ^  M  ^    # 34 #^#
##################### X #     ^#
# ^     ########################
#X^     ########################
######^^#      #################
#   ^   #      #################
#   ^   #      #################
#M ######      #################
#   ^   ^      #################
#   ^          #################
################################
