################################
#    ^       ^     ^      s ^^ #
#    ^ M     ^  M  ^    ###### #
#  ######################    # #
#    ^       ^     ^    # ## # #
#    ^ M     ^  M  ^    # ## #^#
##################### X #     ^#
# ^     ########################
#X^     ########################
######^^#      #################
#   ^   #      #################
#   ^   #      #################
#M ######      #################
#   ^   ^      #################
#   ^          #################
################################
#                              #
#                              #
#                              #
#                              #
#                              #
#                              #
#                              #
#      M                       #
#                              #
#                              #
#                              #
#                              #
#                              #
#                              #
#                              #
#              M               #
#                              #
#                              #
#                              #
#                              #
#                              #
#                              #
#                              #
#                      M       #
#                              #
#                              #
#                              #
#                              #
#                              #
#                              #
#                              #
################################
