################################
#    ^       ^     ^      s ^^ #
#    ^ M     ^  M  ^    ###### #
#  ######################    # #
#    ^       ^     ^    # ## # #
#    ^ M     ^  M  ^    # ## #^#
##################### X #     ^#
# ^     ########################
#X^     ########################
######^^#      #               #
#   ^   #      #               #
#   ^   #      # ####          #
#M ######      # #MM#          #
#   ^   ^      # #M #          #
#   ^          # ####          #
################               #
#                              #
#                              #
#                              #
#                              #
#                              #
#                              #
#                              #
#                              #
#                              #
#                              #
#                              #
#                              #
#                              #
#                              #
#                              #
#                              #
#                              #
#                              #
#                              #
#                              #
#                              #
#                              #
#                              #
#                              #
#                              #
#                              #
#                              #
#                              #
#                              #
#                              #
#                              #
################################
