################################
#           ####################
#    %      |     #            # D:12
#M      #####     # ]      ### #
#       #   #  ~  #######  ### # K:4
# #   % ##  #  +  #######  ### #
# ###   #   #     #######  ### #
#-#$#####  ##     #######  ### # D:13
#^# #  ##   #############  ### #
#   #  ##          #       ### #
#  #   ########    #       ### #
#^ #   ###~   ##   #~     M### # K:12,5
#      ###   ~#    #  ######## # K:11
#  # M ####-###   ##  ######## # D:11
#  #   #   ~ #     #  ######## # K:8
#~ #   #     #######  ######## # K:13
#  #   |                   # # # D:10
#  #   #                  ^~$# # K:10
#  #   #  M                # # #
#  ##-##############   ####### # D:9
#  #! !#   #     $$#   #     #~# K:6
#  # ! #   #     $$#   #  #  # #
#  ## ## # #    #$~#   #  #  # # K:3
##-#####   |    #$$# M #     # # D:8,7
#          #    ####   #     # #
#          #    ####   |^ #  # # D:6
# #   #  # #########   #     # #
#          #>#         #     # #
#          #X#######   #     # #
##### ##############   #  # M# #
#           ########   #  #  # #
#            #######   #     # #
# #####       ######   ##### # #
# #!  #  #~#  ######   #     # # K:1
# #!~ |   #            # ##### # D:5 K:2
# #!  #              ~ #   ~ # # K:9,7
# #####   M            ##### # #
#        ###############+    # #
#######  ##################### #
#     #  ###+         ##     # #
## #  #   #########   ##     # #
## #  #           #   ##     # #
##-#  #           #   ##   # # # D:4
##-#   #     ###  |   ##  $# # # D:3,1
##X#    #    # #  #   ##   # # #
## #     ##  ###  #        # # #
## #      |       #    M   #  ^# D:2
################################
