################################
#            #           #     #
#            #           #     #
#                        #     #
##############    ### ####     #
#   #        #  M #      #     #
#   #             #      #     #
#            #    #            #
#   #     ####    #      #     #
#   #    ##  ##   #      #     #
#   #   ##    ####### ##########
## ######       ~~~~           # K:4,3,2,1
#     # #>                     #
#     # ##    #######          #
#  M  #  ##  ##  #             #
#         ####   #######   M   #
###-###          #             # D:1
### $ #          #     #       #
# #$$$### ########     #       #
# #$$$#         #      #       #
# #####         #  M   #########
#    #      #####         #    #
#    #      #   ####      #    #
#    #      #                  #
#    #   M         #      #    #
#           #      #      ###-## D:2
#    #      #      ########    #
# M  #      #        #    # $  #
#    ########        #    #$ $ #
#           ##########    # $ $#
#                         #$ $ #
### ######### ###### ###########
#       #      #        #      #
#-##    #      #        #      # D:3
#$$#    #      #        #      #
#$$##   #      #        #      #
#$$$#   ####  ##     M  #      #
#####   #      #        ########
#########      #####    #   #  #
#       #      #   #    #   #  #
#              #            #  #
#       #      #   #    #   #  #
#   ## ##########-###########  # D:4
# M #    #     #         #  #  #
#   #    #     #         #  #  #
#   # ?        #         #     #
#   #    #     #$$$$$$$  #  #  #
################################
