################################
#           ####################
#    %      |     #            #
#M      #####     # ]      ### #
#       #   #  ~  #######  ### #
# #   % ##  #  +  #######  ### #
# ###   #   #     #######  ### #
#-#$#####  ##     #######  ### # 8
#^# #  ##   #############  ### #
#   #  ##          #       ### #
#  #   ########    #       ### #
#^ #   ###~   ##   #~     M### # 12, 3
#      ###   ~#    #  ######## # 1
#  # M ####-###   ##  ######## # 1
#  #   #   ~ #     #  ######## # 2
#~ #   #     #######  ######## # 8
#  #   |                   # # # 6
#  #   #                  ^~$# # 6
#  #   #  M                # # #
#  ##-##############   ####### # 11
#  #! !#   #     $$#   #     #~# 5
#  # ! #   #     $$#   #  #  # #
#  ## ## # #    #$~#   #  #  # # 13
##-#####   |    #$$# M #     # # 2, 7
#          #    ####   #     # #
#          #    ####   |^ #  # # 5
# #   #  # #########   #     # #
#          #>#         #     # #
#          #X#######   #     # # B
##### ##############   #  # M# #
#           ########   #  #  # #
#            #######   #     # #
# #####       ######   ##### # #
# #!  #  #~#  ######   #     # # 4
# #!~ |   #            # ##### # 9, 3
# #!  #              ~ #   ~ # # 11, 7
# #####   M            ##### # #
#        ###############+    # #
#######  ##################### #
#     #  ###+         ##     # #
## #  #   #########   ##     # #
## #  #           #   ##     # #
##-#  #           #   ##   # # # 10
##-#   #     ###  |   ##  $# # # 13, 4
##X#    #    # #  #   ##   # # # A
## #     ##  ###  #        # # #
## #      |       #    M   #  ^# 9
################################
