################################
#~|               ^            # D:16 K:14
#-                #            # D:15
#    #s##-#  #M######  ####    # D:14
#    ####~#  ########  ###s    # K:10
#    ######  ########^#####    #
#  ########  ########  ####    #
#  ########  ########  #########
#  ########  ########  #########
#  %#####      ######  #### ~~ # K:3,4
#  ###M##      ###$##  #### ~~ # K:1,2
#                         -    # D:12
#                         -    # D:11
#  ######      ####-#######    # D:13
#  %#####      ####~#######    # K:9
#  ########  ################+##
#  ########  ###################
#  ########  M###      #########
#  ########  ####~   > ######### K:8
#  ########  ####      #########
##^#######s  !###      #########
#  ########  #### X    #########
#  ########  ####      #########
#  ########  ###################
#  ########  ###################
#  ######      #################
#  ######      ############s####
#          M$      ^           #
#          $M      #           #
#  ######      ##########$###  #
#  s#####      ##############  #
#  ########  ################  #
#  ########  ############$###  #
#  |~#####+  #####             # D:10 K:13
#  ########  #####             #
#^#########         #M#######  #
#  ########         #########  #
#  ###############  ########%  #
#  $###############^######### ~# K:15
#  ###############  ######### ~# K:16
#  ############$##  #########  #
#  ###########         ######--# D:3,4
#--###########         ####    # D:8,9
#     |    ^       M     |^    # D:2,7
#     |    #             |#    # D:1,6
#~ ~  ########    #-#  ####    # D:5 K:7,12
# ~ ~ s#######    #X#  #### ~ M# K:5,6,11
################################
