################################
#        ######        #   # # #
#         ####           #  #  #
#          ##           # #    #
#$                      ##  #  #
#                      #   #   #
#                 M    # #     #
#$                     #       #
#       ########       #       #
##      #~     #      ##    M  # 1
###     #      #     ###       #
####    #      #    ####       #
####    #      |    ####~ ~  ~ # 1, 4, 3, 2
###     #      #     ###########
##   $  #= = ==#      ##    $  #
#       ########       # ~     # 20
#         $$ $         #   ~  ~# 9, 19
#                      #       #
#    M                $#     $ #
# $                    # ~     # 18
#          ##     %    #      ~# 10
#         ####         #   ~   # 17
#   $    ######        #       #
###---##################       # 2, 3, 4
#      ###             ~       # 8
#      ###                     #
#      ###         %       M  ~# 16
#      ###              ~      # 7
#~     ###                     # 5
#      ###                 ~   # 15
#      #######    ######       #
#      ###           $ #  ~  $ # 11
#~     ###            $#       # 6
#   M  ###             #~    ~ # 14, 13
#      ###  M          #   ~   # 12
#      ###             #       #
#$     ###             #-------# 20, 18, 9, 10, 19, 17, 8
#      ###           % #-------# 16, 15, 7, 11, 13, 12, 14
#     $###           % #       #
#    $$###             #       #
#     $###       M     #       #
#      ###             #       #
#      ###             #   M   #
#      ###             #       #
#      ###             #       #
#        |             #       # 5
#        |         $   #      ># 6
################################
