################################
#      ##   $$ ##      ##   $  #
# $$   ##      ##  )   ##   $  #
#      ##      ## $    ##   $  #
####-#######-#######-#######-### D:8,7,6,5
#                              #
#           M                  #
#  ### ##########$     ##      #
#  ### ##########      ##      #
#  ### ##  $ $ ##      ##   M  #
#  ### ## #### ##$             #
#  ### ## |~ # ##              # D:4 K:4
#  #~+ ## # ~| #############   # D:3 K:7,3
#  ###### #### ###  ~      ~   # K:1,8
#    %           M             #
#  ##  ##################      #
#  ##  ##################      #
#  ##  ##  $ ? ##  %   ###     #
#M ##~ ##     $##        ##   $# K:2
#  ##  ##      ##~        #    # K:6
#  ##  ##      ##            % #
#  ##  |       ##    ####      # D:2
#  ##  ##  M   ## ]  #   #     #
#  ##  ##########    #         #
#  ##  ##########    #         #
#  #   ##  ~ ####   M#         # K:5
#-##   ##    #########   ### ### D:1
#$ #   ##    #$##        #     #
# $#         ^           #     #
#$ #   ##    #$##        #  >  #
# $# M ##    ####        #     #
################################
#                              #
#                              #
#                              #
#                              #
#                              #
#                              #
#                              #
#                              #
#                             M#
#                              #
#                              #
#                              #
#                              #
#                              #
#                              #
################################
