 ###############################
#####      $       $  $        #
####>  #     ##        ##  ##  #
###               M   ]        #
##      ##  ###    #     #   # #
#           M   $          $   #
#  ###    #       #    #########
#                   ~ #####    # 7
#     ######################-# # 5
#    ####################    # #
# $ #####################    # #
#   #####  ~~    |^|^      M # # 1, 2, 1, 2
#   #####  ~   ##########    # # 3
#   #####################    # #
#   #####################    # #
#   #######################-## # 3
#   M         ############   # #
#           ! ##             # #
#########-###### ######### $ # # 6
#  ###         # #$#######   # #
#  ###  $      #  $          # #
#  ###    #    ###$##-#### M # # 7
#  #####  #    ###$# ]#  #   # #
#  #####  #### #####  #  #   #M#
#  #####  ####-##        #   # # 4
#  #####  ###   #        #   # #
#  #####  ###   ########## % # #
#  #####  ###                # #
#    ###  ### #######  ###  $# #
# $  ###  ###########  ###   #$#
#    ###  ###########  ###  $#$#
#  M ###  ###########  ##    #?#
#    ###  ###########  ##    ###
#         ###### ########      #
#####  ########% ~####### ##   # 5
#####   ######  # ####### ## ~ # 4
#####    ####  ##$        ##   #
######  $ ### ####        ##   #
#######    ## #### #########   #
#    ###     M#### #########   #
# ~  ####     #### ############# 6
#  $ ###  ###  ##  #############
#    ##  #####    ##############
#)      #######  ###############
#      #########################
################################
################################
################################
