################################
#   #      $       $  $        #
#  #>  #      ##       ##  ##  #
# #               M   ]        #
##      ##  ###    #     #   # #
#           M   $          $   #
#  ###    #       #    #########
#                     #####    #
#     ################  ####-# # D:4
#    #                  #    # #
# $ #  ##################    # #
#   #  #   ~~    |^|^      M # # D:5,6 K:5,6
#   #  #   ~   ##########    # # K:3
#   #  #########        #    # #
#   #                   #    # #
# % ###########         ###-## # D:3
#   M         #          #   # #
#           ! #          #   # #
#########-###### ###     # $ # # D:2
#  # #         # #$#######   # #
#  # #  $      # #$          # #
#  # #    #    # #$####### M # #
#  # ###  #    # #$#     #   # #
#  #   #  #### # ###     #   #M#
#  #   #  # ##-##        #   # # D:1
#  #   #  # #   #        #   # #
#  #   #  # #   ########## % # #
#  ### #  # #               $# #
#    # #  # # #######  ###   # #
# $  # #  # ###     #  # #  $#$#
#    # #  #         #  # #   #+#
#  M # #  #         #  ###   #?#
#    ###  #     #   #  ##    ###
#         #    # #  #####      #
#####  ####   #% ~#     # ##   # K:4
#   #   #    #  # ####### ## ~ # K:1
#   #    #  #  ##$        ##   #
#    #  $ # # ####        ##   #
#######    ## #### #########   #
#    # #     M#### #       #   #
# ~  #  #     #### #       ##### K:2
#  $ # #  ###  ##  #           #
#    ##  #   #    #            #
#)      #     #  #             #
#      #       ##              #
#######                        #
#                              #
################################
