################################
##%  ###  ##    ##########   ###
##        |      ~#####    +   # D:1 K:7
#   #   ###    $    ##    ###  #
#~         ##            #    ## K:4
#  ## $   ### ##              ##
#        #~  #  #            ### K:3
##   M   #       ##-#  #    #### D:2
####   ###   #   #   #   M######
#   #  #    ##   #   #     #####
#   ###         #     #     ####
#              #       ##   ####
###    M       #  $          ###
#####         #          #  ####
##### $ #######        ##     ##
####        ##   ~   ##        # K:2
###       %   #     #    #     #
## ##         #    #           #
#    ####      ####     $     ##
#        ####  |      #     #### D:3
#       #    ###    ~      #   # K:1
#   $  #] ##    ###      #-#   # D:4
##    #   #    #   ##   #     ##
##  # #   #   #      # #       #
### ## $     #        #  M  $  #
###          |    #           ## D:5
###% M ##    #     #  %       ##
###      ##   #   $~#      # ### K:5
###  #     ####    #    # ######
####  #    #   #  #    #########
####  ##  #     #     ##########
#####  ~##       ###-########### D:6 K:6
#####  #   ###   # #  ##########
#$#####   #      # #  ##########
#$$#  #   #$    #        # #####
#$$|   ###      ##        ] # ## D:7
#$##     #   M   ##         #~ # K:9
##  ###   #     #  ##   $   #~ # K:8
# #   ##  ##  ##     ## ## #   #
##   #  #  #  |      ####  #  ## D:8
#    #  #  #  #   #   #    #   #
##  # M   #    # ##   #%  #    #
#   # >   #-## #   $  #   # $ ## D:9
# % #$      #######   # M#   ###
#        # ##########         ##
##    # ##############       ###
###  ##################  #  ####
################################
