 ###############################
 #           #          %#     #
 #     #     #     #     #   $ #
 ##### #     ##### #     #$    #
 #     ##### #     ##### #     #
 #  ~  #$    #   M # ~   #     # K:3,4
 #     #           #           #
####-########################### D:1
#               ~              # K:1
#          X]        #M#       #
###########################    #
#  #     #    #     # $   #    #
#  #  $  #    #  M  #     #    #
#  #     #    #     #     |    # D:4
#  #    #    X #    #     #    #
#  |    ########    |     #    # D:2,3
#  #                #     #  % #
#  ####################-###    # D:17
#   ~|~|~|     |~|~|~     #    # D:5,6,7,8,18,19 K:5,6,7,8,18,19
###########   #############    #
          #~  #           #  M # K:16
         #  M  #          #$   #
        #~~~~~~~#         #$   # K:9,10,11,12,13,14,15
       #--------########  #$   # D:9,10,11,12,13,14,15,16
########   $        #  #  #    #
#     #             #  #  #    #
#     #                #  # %  #
# $                 #  #  #    #
#     #   $   $     #  #  #    #
#   ~ ##################  #    # K:20
#     #                #  #~   # K:2
#     #      )         #  #    #
#                    $ #  #  M #
# $   #                #  #    #
#     ########-#########  #    # D:20
##########        %   #####    #
#          ########## #   #  % #
#          #        # #   #    #
#% #     # # ###### # #   #    #
#    M     # #    # # #   #    #
#          # # ## # # #   #  ~ # K:17
# #   #    # # #> # # #   #    #
#  # #     #M# #### # #   #    #
#   #    # # #      # #   #    #
#  # # %   # ######## #   #    #
# #   #    #          #   #^#^##
#          ############   # ?  #
################################
