################################
#      ##   $$ ##      ##   $  #
# $$   ##      ##  )   ##   $  #
#      ##      ## $    ##   $  #
####-#######-#######-#######-### 5, 6, 7, 8
#                              #
#           M                  #
#  ### ##########$     ##      #
#  ### ##########      ##      #
#  ### ##  $ $ ##      ##   M  #
#  ### ## #### ##$             #
#  ### ## |~ # ##              # 2, 2
#  #~+ ## # ~| #############   # 6, 1, 1
#  ###### #### ###  ~      ~   # 4, 5
#    %           M             #
#  ##  ##################      #
#  ##  ##################      #
#  ##  ##  $ ? ##  %   ###     #
#M ##~ ##     $##        ##   $# 3
#  ##  ##      ##~        #    # 7
#  ##  ##      ##            % #
#  ##  |       ##    ####      # 3
#  ##  ##  M   ## ]  #   #     #
#  ##  ##########    #         #
#  ##  ##########    #         #
#  #   ##  ~ ####   M#         # 8
#-##   ##    #########   ### ### 4
#$ #   ##    #$##        #     #
# $#         ^           #     #
#$ #   ##    #$##        #  >  #
# $# M ##    ####        #     #
################################
#                              #
#                              #
#                              #
#                              #
#                              #
#                              #
#                              #
#           M                  #
#                              #
#                              #
#                              #
#                              #
#                              #
#                              #
#                              #
################################
