################################
#        ######        #   # # #
#         ####           #  #  #
#          ##           # #    #
#$                      ##  #  #
#                      #   #   #
#                 M    # #     #
#$                     #       #
#       ########       #       #
##      #~     #      ##    M  # K:1
###     #      #     ###       #
####    #      #    ####       #
####    #      |    ####~ ~  ~ # D:1 K:4,3,2
###     #      #     ###########
##   $  #s s ss#      ##    $ $#
#       ########       # ~     # K:5
#         $$ $         #       #
#                      #   ~  ~# K:7,9
#    M                $#       #
# $                    #     $ #
#          ##     %    # ~     # K:6
#         ####         #      ~# K:8
#   $    ######        #   ~   # K:10
###---##################       # D:2,3,4
#      ###             ~       # K:11
#      ###                     #
#      ###         %       M  ~# K:12
#      ###              ~      # K:14
#~     ###                     # K:19
#      ###                 ~   # K:13
#      #######    ######       #
#      ###           $ #  ~  $ # K:15
#~     ###            $#       # K:20
#   M  ###             #~    ~ # K:18,16
#      ###  M          #       #
#      ###             #   ~   # K:17
#$     ###             #-------# D:5,6,7,8,9,10,11
#      ###           % #-------# D:12,13,14,15,16,17,18
#     $###           % #       #
#    $$###             #       #
#     $###       M     #       #
#      ###             #       #
#      ###             #   M   #
#      ###             #       #
#      ###             #       #
#        |             #       # D:19
#        |         $   #      ># D:20
################################
