################################
#~|               ^            # 3, 1
#-                #            # 2
#    #=##-#  #M######  ####    # 3
#    ####~#  ########  ###=    # 4
#    ######  ########^#####    #
#  ########  ########  ####    #
#  ########  ########  #########
#  ########  ########  #########
#  %#####      ######  #### ~~ # 8, 10
#  ###M##      ###$##  #### ~~ # 11, 12
#                         -    # 7
#                         -    # 13
#  ######      ####-#######    # 5
#  %#####      ####~#######    # 6
#  ########  ################+##
#  ########  ###################
#  ########  M###      #########
#  ########  #### ~  > ######### 16
#  ########  ####      #########
##^#######=  !###      #########
#  ########  #### X    ######### B
#  ########  ####      #########
#  ########  ###################
#  ########  ###################
#  ######      #################
#  ######      ############=####
#          M$      ^           #
#          $M      #           #
#  ######      ##########$###  #
#  =#####      ##############  #
#  ########  ################  #
#  ########  ############$###  #
#  |~#####+  #####             # 4, 5
#  ########  #####             #
#^#########         #M#######  #
#  ########         #########  #
#  ###############  ########=  #
#  $###############^######### ~# 2
#  ###############  ######### ~# 1
#  ############$##  #########  #
#  ###########         ######--# 8, 10
#--###########         ####    # 6, 16
#     |    ^       M     |^    # 14, 12
#     |    #             |#    # 15, 11
#~ ~  ########    #-#  ####    # 7, 14, 9
# ~ ~ =#######    #X#  #### ~ M# 13, 15, A, 9
################################
