################################
#####    ##           |    ##### 5
#####    ##     M     #     ####
#####    ##           #      ###
#####~   ##           ######  ##
#####    ## # # # # # #    #   #
#####    ## # # # # # #  ~ #   # 2
#####    ## # # # # # #    #   #
######-# ## #~# #~# # ##-# #   # 2, 5, 6, 1
######^############-####^##### # 4
#                 # #        # #
#                #   #       # #
#                        ##### #
#                          ~M# # 1
#####################^######## #
################### #-######## # 3
#######   %?    ###    ##   ## #
#######         ###    ##   ## #
####### #####   ###    ##   ## #
####### ###### ####    ##~  |  # 11, 12
#           ## ####~   ##   ## # 4
# ######### ## ####    #=    # #
# ######### ## ####    #     # #
# ##    ### ## ####    #     #M#
# ##^   ### ## ####    #     # #
# ##X^  ### ## ###########-### # E, 10
# ####-#### ## ###             # 11
#                 M### ###-### # 6
# ######### ########     # ~ # # 7
# ######### ########    $#   # #
# ######### ########     # $ # #
# ######### ######## ######### #
#    ######                    #
#    ## + # ## ## ####### ######
# ]]$##  M  ## ## ####### ######
#    ##     ## ## #   %## ######
#    ## )   ## ##      ## ######
## #####  $$## ## #  #### ######
##     ####### ## #  #       ###
#### # M  #M   ## #  #   $   ###
#### #### # ##### #% #       ###
### # ### # ##### #$ #       ###
#X     X#~# ##### ###### ####### A, B, 8
#  #X#  #-#-##      #### ##   $# C, 7, 8
#  #>#  # # ##-#        M## %  #
# #   # # # ##~#    ####     $ # 10
##  X  ##  ~##~#    #######    # D, 9, 12
################################
