################################
##%  ###  ##    ##########   ###
##        |      ~#####    +   # 2, 9
#   #   ###    $    ##    ###  #
#~    $    ##            #    ## 3
#  ##     ### ##              ##
#        #~  #  #            ### 1
##   M   #       ##-#  #    #### 8
####   ###   #   #   #   M######
#   #  #    ##   #   #     #####
#   ###         #     #     ####
#              #       ##   ####
###    M       #  $          ###
#####         #          #  ####
##### $ #######        ##     ##
####        ##   ~   ##        # 8
###       %   #     #    #     #
## ##         #    #           #
##   ####      ####     $     ##

:q

