################################
##### ##########################
#####>##########################
#####^##########################
####   ###$                    #
###     #####       ###    ### #
##       #     M   #    % #    #
## ## ## #$       #      #     #
## ## ## #### ####   ####      #
## ## ## #                     #
## ## ## #####################-# D:1
## ## ## ##  #                 #
## ## ## ##  ^      ~    M     # K:2
## ## ## #####################-# D:2
##       #                     #
###     ##     ~               # K:1
####   ### %       ###      ####
##### ####     ### # #   M  #  #
#   # #  ~   ### # # #      #  # K:4
##    #     ###  # #%#-#  ~ #  # D:3 K:5
#  ## #    ###   ### # ####-#  # D:4
# # #^#    ##      # # #       #
#   #$#   ##    #### # #       #
#   ###   #          #^#    %  #
#         #          #%#       #
#        %  ~  ##############  # K:3
# #####        # # # # # #%#   #
#   ###   #  M #       |       # D:5
#         #    #       #     M #
#      M  #   #  ###############
#~        #   #     ~$########## K:8,14
#       ~ #   #  ############### K:11
###-####  #    #       #       # D:6
# ] #$|~       #       |      ~# D:7,14 K:6,13
#######        # # # # # # #   #
# + #)#  ####--############### # D:12,13
##-##-## #                #### # D:8,9
##  # #  #                #### #
#!# |?# ~#  $% M          #### # D:10 K:10
#-# ## # #                #### # D:11
#        #                #### #
# ~  ~   # # ####       % # ^# # K:7,9
########## # ###########  # X  #
#   ~      # ####      ## # #### K:12
#  #########            ###    #
##          %            ##### #
#!     #####         M         #
################################
